    #############      #############    
    #                              #    
    #                              #    
    #                              #    
#####                              #####
#                                      #
#                                      #
#                                      #
#                                      #
#                                      #
#                                      #
#                                      #
#                                      #
#                                      #
#                                      #
#                                      #
#                                      #
                 #####                  
                 #   #                  
                 #   #                  
                 #   #                  
                 #   #                  
                 #####                  
#                                      #
#                                      #
#                                      #
#                                      #
#                                      #
#                                      #
#                                      #
#                                      #
#                                      #
#                                      #
#                                      #
#                                      #
#####                              #####
    #                              #    
    #                              #    
    #                              #    
    #############      #############    
