#################      #################
#####                              #####
#####                              #####
#####                              #####
#####                              #####
#                                      #
#                                      #
#                                      #
#                                      #
#                                      #
#                                      #
#                                      #
#                                      #
#                                      #
#                                      #
#                                      #
#                                      #
                 #####                  
                 #####                  
                 #####                  
                 #####                  
                 #####                  
                 #####                  
#                                      #
#                                      #
#                                      #
#                                      #
#                                      #
#                                      #
#                                      #
#                                      #
#                                      #
#                                      #
#                                      #
#                                      #
#####                              #####
#####                              #####
#####                              #####
#####                              #####
#################      #################
